"filename", "language", "Python", "comment", "blank", "total"
"d:\Research\Huang\Rebuttal\Experiment\BVVI\src\BVVI.py", "Python", 199, 63, 29, 291
"d:\Research\Huang\Rebuttal\Experiment\BVVI\src\BVVI_ablation.py", "Python", 196, 64, 33, 293
"d:\Research\Huang\Rebuttal\Experiment\BVVI\src\DP.py", "Python", 107, 31, 27, 165
"d:\Research\Huang\Rebuttal\Experiment\BVVI\src\POMDP_model.py", "Python", 271, 20, 50, 341
"d:\Research\Huang\Rebuttal\Experiment\BVVI\src\RSVI2.py", "Python", 62, 1, 10, 73
"d:\Research\Huang\Rebuttal\Experiment\BVVI\src\brute_force.py", "Python", 57, 1, 13, 71
"d:\Research\Huang\Rebuttal\Experiment\BVVI\src\utils.py", "Python", 407, 38, 104, 549
"d:\Research\Huang\Rebuttal\Experiment\BVVI\src\main.py", "Python", 463, 74, 78, 615
"d:\Research\Huang\Rebuttal\Experiment\BVVI\src\monte_carlo.py", "Python", 122, 31, 29, 182
"d:\Research\Huang\Rebuttal\Experiment\BVVI\src\naive_test.py", "Python", 104, 21, 31, 156
"d:\Research\Huang\Rebuttal\Experiment\BVVI\src\plot.py", "Python", 86, 21, 24, 131
"d:\Research\Huang\Rebuttal\Experiment\BVVI\src\temp.py", "Python", 2, 0, 4, 6
"Total", "-", 2076, 365, 432, 2873